111111111111111
1000100000000C1
1000000C0000001
111100000011111
11000000111E111
110000000000011
111P00001010111
111111111111111