1111111
1P11111
1C0E001
1110111